R 600 400

NO ./texture/bluestone.xpm

S ./texture/sprite_1.xpm

WE ./texture/wall_3.xpm

EA   ./texture/wall_2.xpm

SO ./texture/wall_1.xpm   

C    104    ,    192    ,    253 

F 83,52, 31

1111111111111111111111111111111
1000000000000000000000000000001
1000000000000100000000000000001
1001111000000000000001110000001
10000000E0002000000000000000001
1000111110000000000010000000001
1000000000000200000000000000001
1000000000000000000000000000001
1001111111111111111100011111111
1000000000000200000000000000001
1000000000001110000000000000001
1000000000000000000000000000001
1000000000000020202000000000001
1001110000000000000000000000001
1001111111111111111100011111111
1000000000000000000000000000001
1000111111000000000000000000001
1000000000000000000000000000001
1111111111111111111111111111111