R 1200 900

NO ./texture/bluestone.xpm

S ./texture/sprite_1.xpm

WE ./texture/wall_3.xpm

EA   ./texture/wall_2.xpm

SO ./texture/wall_1.xpm   

C    104    ,    192    ,    253 

F 83,52, 31

1111111111111
122222S222221
1222220222221
1222220222221
1222220222221
1222220222221
1222220222221
1222220222221
1222220222221
1222220222221
1222220222221
1222220222221
1222220222221
1222220222221
1222220222221
1222220222221
1222220222221
1222220222221
1222220222221
1222220222221
1222220222221
1222220222221
1222220222221
1222220222221
1222220222221
1222220222221
1222220222221
1222220222221
1222220222221
1222220222221
1222220222221
1222220222221
1222220222221
1222220222221
1222220222221
1222220222221
1222220222221
1222220222221
1222220222221
1222220222221
1222220222221
1222220222221
1222220222221
1222220222221
1222220222221
1222220222221
1222220222221
1222220222221
1222220222221
1222220222221
1222220222221
1222220222221
1222220222221
1222220222221
1222220222221
1222220222221
1222220222221
1222220222221
1222220222221
1222220222221
1222220222221
1222220222221
1222220222221
1222220222221
1222220222221
1222220222221
1222220222221
1222220222221
1222220222221
1222220222221
1222220222221
1222220222221
1222220222221
1222220222221
1222220222221
1222220222221
1222220222221
1222220222221
1222220222221
1222220222221
1222220222221
1222220222221
1222220222221
1222220222221
1222220222221
1222220222221
1222220222221
1222220222221
1222220222221
1222220222221
1222220222221
1222220222221
1222220222221
1222220222221
1222220222221
1222220222221
1222220222221
1222220222221
1222220222221
1222220222221
1222220222221
1222220222221
1222220222221
1222220222221
1222220222221
1222220222221
1222220222221
1222220222221
1222220222221
1222220222221
1222220222221
1222220222221
1222220222221
1222220222221
1222220222221
1222220222221
1222220222221
1222220222221
1222220222221
1222220222221
1222220222221
1222220222221
1222220222221
1222220222221
1222220222221
1222220222221
1222220222221
1222220222221
1222220222221
1222220222221
1222220222221
1222220222221
1222220222221
1222220222221
1222220222221
1222220222221
1222220222221
1222220222221
1222220222221
1222220222221
1222220222221
1222220222221
1222220222221
1222220222221
1222220222221
1222220222221
1222220222221
1222220222221
1222220222221
1222220222221
1222220222221
1222220222221
1222220222221
1222220222221
1222220222221
1222220222221
1222220222221
1222220222221
1222220222221
1222220222221
1222220222221
1222220222221
1222220222221
1222220222221
1222220222221
1222220222221
1222220222221
1222220222221
1222220222221
1222220222221
1222220222221
1222220222221
1222220222221
1222220222221
1222220222221
1222220222221
1222220222221
1222220222221
1222220222221
1222220222221
1222220222221
1222220222221
1222220222221
1222220222221
1222220222221
1222220222221
1222220222221
1222220222221
1222220222221
1222220222221
1222220222221
1222220222221
1222220222221
1222220222221
1222220222221
1222220222221
1222220222221
1222220222221
1222220222221
1222220222221
1222220222221
1222220222221
1222220222221
1222220222221
1222220222221
1222220222221
1222220222221
1222220222221
1222220222221
1222220222221
1222220222221
1222220222221
1222220222221
1222220222221
1222220222221
1222220222221
1222220222221
1222220222221
1222220222221
1222220222221
1222220222221
1222220222221
1222220222221
1222220222221
1222220222221
1222220222221
1222220222221
1222220222221
1222220222221
1222220222221
1222220222221
1222220222221
1222220222221
1222220222221
1222220222221
1222220222221
1222220222221
1222220222221
1222220222221
1222220222221
1222220222221
1222220222221
1222220222221
1222220222221
1222220222221
1222220222221
1222220222221
1222220222221
1222220222221
1222220222221
1222220222221
1222220222221
1222220222221
1222220222221
1222220222221
1222220222221
1222220222221
1222220222221
1222220222221
1222220222221
1222220222221
1222220222221
1222220222221
1222220222221
1222220222221
1222220222221
1222220222221
1222220222221
1222220222221
1222220222221
1222220222221
1222220222221
1222220222221
1222220222221
1222220222221
1222220222221
1222220222221
1222220222221
1222220222221
1222220222221
1222220222221
1222220222221
1222220222221
1222220222221
1222220222221
1222220222221
1222220222221
1222220222221
1222220222221
1222220222221
1222220222221
1222220222221
1222220222221
1222220222221
1222220222221
1222220222221
1222220222221
1222220222221
1222220222221
1222220222221
1222220222221
1222220222221
1222220222221
1222220222221
1222220222221
1222220222221
1222220222221
1222220222221
1222220222221
1222220222221
1222220222221
1222220222221
1222220222221
1222220222221
1222220222221
1222220222221
1222220222221
1222220222221
1222220222221
1222220222221
1222220222221
1222220222221
1222220222221
1222220222221
1222220222221
1222220222221
1222220222221
1222220222221
1222220222221
1222220222221
1222220222221
1222220222221
1222220222221
1222220222221
1222220222221
1222220222221
1222220222221
1222220222221
1222220222221
1222220222221
1222220222221
1222220222221
1222220222221
1222220222221
1222220222221
1222220222221
1222220222221
1222220222221
1222220222221
1222220222221
1222220222221
1222220222221
1222220222221
1222220222221
1222220222221
1222220222221
1222220222221
1222220222221
1222220222221
1222220222221
1222220222221
1222220222221
1222220222221
1222220222221
1222220222221
1222220222221
1222220222221
1222220222221
1222220222221
1222220222221
1222220222221
1222220222221
1222220222221
1222220222221
1222220222221
1222220222221
1222220222221
1222220222221
1222220222221
1222220222221
1222220222221
1222220222221
1222220222221
1222220222221
1222220222221
1222220222221
1222220222221
1222220222221
1222220222221
1222220222221
1222220222221
1222220222221
1222220222221
1222220222221
1222220222221
1222220222221
1222220222221
1222220222221
1222220222221
1222220222221
1222220222221
1222220222221
1222220222221
1222220222221
1222220222221
1222220222221
1222220222221
1222220222221
1222220222221
1222220222221
1222220222221
1222220222221
1222220222221
1222220222221
1222220222221
1222220222221
1222220222221
1222220222221
1222220222221
1222220222221
1222220222221
1222220222221
1222220222221
1222220222221
1222220222221
1222220222221
1222220222221
1222220222221
1222220222221
1222220222221
1222220222221
1222220222221
1222220222221
1222220222221
1222220222221
1222220222221
1222220222221
1222220222221
1222220222221
1222220222221
1222220222221
1222220222221
1222220222221
1222220222221
1222220222221
1222220222221
1222220222221
1222220222221
1222220222221
1222220222221
1222220222221
1222220222221
1222220222221
1222220222221
1222220222221
1222220222221
1222220222221
1222220222221
1222220222221
1222220222221
1222220222221
1222220222221
1222220222221
1222220222221
1222220222221
1222220222221
1222220222221
1222220222221
1222220222221
1222220222221
1222220222221
1222220222221
1222220222221
1222220222221
1222220222221
1222220222221
1222220222221
1222220222221
1222220222221
1222220222221
1222220222221
1222220222221
1222220222221
1222220222221
1222220222221
1222220222221
1222220222221
1222220222221
1222220222221
1222220222221
1222220222221
1222220222221
1222220222221
1222220222221
1222220222221
1222220222221
1222220222221
1222220222221
1222220222221
1222220222221
1222220222221
1222220222221
1222220222221
1222220222221
1222220222221
1222220222221
1222220222221
1222220222221
1222220222221
1222220222221
1222220222221
1222220222221
1222220222221
1222220222221
1222220222221
1222220222221
1222220222221
1222220222221
1222220222221
1222220222221
1222220222221
1222220222221
1222220222221
1222220222221
1222220222221
1222220222221
1222220222221
1222220222221
1222220222221
1222220222221
1222220222221
1222220222221
1222220222221
1222220222221
1222220222221
1222220222221
1222220222221
1222220222221
1222220222221
1222220222221
1222220222221
1222220222221
1222220222221
1222220222221
1222220222221
1222220222221
1222220222221
1222220222221
1222220222221
1222220222221
1222220222221
1222220222221
1222220222221
1222220222221
1222220222221
1222220222221
1222220222221
1222220222221
1222220222221
1222220222221
1222220222221
1222220222221
1222220222221
1222220222221
1222220222221
1222220222221
1222220222221
1222220222221
1222220222221
1222220222221
1222220222221
1222220222221
1222220222221
1222220222221
1222220222221
1222220222221
1222220222221
1222220222221
1222220222221
1222220222221
1222220222221
1222220222221
1222220222221
1222220222221
1222220222221
1222220222221
1222220222221
1222220222221
1222220222221
1222220222221
1222220222221
1222220222221
1222220222221
1222220222221
1222220222221
1222220222221
1222220222221
1222220222221
1222220222221
1222220222221
1222220222221
1222220222221
1222220222221
1222220222221
1222220222221
1222220222221
1222220222221
1222220222221
1222220222221
1222220222221
1222220222221
1222220222221
1222220222221
1222220222221
1222220222221
1222220222221
1222220222221
1222220222221
1222220222221
1222220222221
1222220222221
1222220222221
1222220222221
1222220222221
1222220222221
1222220222221
1222220222221
1222220222221
1222220222221
1222220222221
1222220222221
1222220222221
1222220222221
1222220222221
1222220222221
1222220222221
1222220222221
1222220222221
1222220222221
1222220222221
1222220222221
1222220222221
1222220222221
1222220222221
1222220222221
1222220222221
1222220222221
1222220222221
1222220222221
1222220222221
1222220222221
1222220222221
1222220222221
1222220222221
1222220222221
1222220222221
1222220222221
1222220222221
1222220222221
1222220222221
1222220222221
1222220222221
1222220222221
1222220222221
1222220222221
1222220222221
1222220222221
1222220222221
1222220222221
1222220222221
1222220222221
1222220222221
1222220222221
1222220222221
1222220222221
1222220222221
1222220222221
1222220222221
1222220222221
1222220222221
1222220222221
1222220222221
1222220222221
1222220222221
1222220222221
1222220222221
1222220222221
1222220222221
1222220222221
1222220222221
1222220222221
1222220222221
1222220222221
1222220222221
1222220222221
1222220222221
1222220222221
1222220222221
1222220222221
1222220222221
1222220222221
1222220222221
1222220222221
1222220222221
1222220222221
1222220222221
1222220222221
1222220222221
1222220222221
1222220222221
1222220222221
1222220222221
1222220222221
1222220222221
1222220222221
1222220222221
1222220222221
1222220222221
1222220222221
1222220222221
1222220222221
1222220222221
1222220222221
1222220222221
1222220222221
1222220222221
1222220222221
1222220222221
1222220222221
1222220222221
1222220222221
1222220222221
1222220222221
1222220222221
1222220222221
1222220222221
1222220222221
1222220222221
1222220222221
1222220222221
1222220222221
1222220222221
1222220222221
1222220222221
1222220222221
1222220222221
1222220222221
1222220222221
1222220222221
1222220222221
1222220222221
1222220222221
1222220222221
1222220222221
1222220222221
1222220222221
1222220222221
1222220222221
1222220222221
1222220222221
1222220222221
1222220222221
1222220222221
1222220222221
1222220222221
1222220222221
1222220222221
1222220222221
1222220222221
1222220222221
1222220222221
1222220222221
1222220222221
1222220222221
1222220222221
1222220222221
1222220222221
1222220222221
1222220222221
1222220222221
1222220222221
1222220222221
1222220222221
1222220222221
1222220222221
1222220222221
1222220222221
1222220222221
1222220222221
1222220222221
1222220222221
1222220222221
1222220222221
1222220222221
1222220222221
1222220222221
1222220222221
1222220222221
1222220222221
1222220222221
1222220222221
1222220222221
1222220222221
1222220222221
1222220222221
1222220222221
1222220222221
1222220222221
1222220222221
1222220222221
1222220222221
1222220222221
1222220222221
1222220222221
1222220222221
1222220222221
1222220222221
1222220222221
1222220222221
1222220222221
1222220222221
1222220222221
1222220222221
1222220222221
1222220222221
1222220222221
1222220222221
1222220222221
1222220222221
1222220222221
1222220222221
1222220222221
1222220222221
1222220222221
1222220222221
1222220222221
1222220222221
1222220222221
1222220222221
1222220222221
1222220222221
1222220222221
1222220222221
1222220222221
1222220222221
1222220222221
1222220222221
1222220222221
1222220222221
1222220222221
1222220222221
1222220222221
1222220222221
1222220222221
1222220222221
1222220222221
1222220222221
1222220222221
1222220222221
1222220222221
1222220222221
1222220222221
1222220222221
1222220222221
1222220222221
1222220222221
1222220222221
1222220222221
1222220222221
1222220222221
1222220222221
1222220222221
1222220222221
1222220222221
1222220222221
1222220222221
1222220222221
1222220222221
1222220222221
1222220222221
1222220222221
1222220222221
1222220222221
1222220222221
1222220222221
1222220222221
1222220222221
1222220222221
1222220222221
1222220222221
1222220222221
1222220222221
1222220222221
1222220222221
1222220222221
1222220222221
1222220222221
1222220222221
1222220222221
1222220222221
1222220222221
1222220222221
1222220222221
1222220222221
1222220222221
1222220222221
1222220222221
1222220222221
1222220222221
1222220222221
1222220222221
1222220222221
1222220222221
1222220222221
1222220222221
1222220222221
1222220222221
1222220222221
1222220222221
1222220222221
1222220222221
1222220222221
1222220222221
1222220222221
1222220222221
1222220222221
1222220222221
1222220222221
1222220222221
1222220222221
1222220222221
1222220222221
1222220222221
1222220222221
1222220222221
1222220222221
1222220222221
1222220222221
1222220222221
1222220222221
1222220222221
1222220222221
1222220222221
1222220222221
1222220222221
1222220222221
1222220222221
1222220222221
1222220222221
1222220222221
1222220222221
1222220222221
1222220222221
1222220222221
1222220222221
1222220222221
1222220222221
1222220222221
1222220222221
1222220222221
1222220222221
1222220222221
1222220222221
1222220222221
1222220222221
1222220222221
1222220222221
1222220222221
1222220222221
1222220222221
1222220222221
1222220222221
1222220222221
1222220222221
1222220222221
1222220222221
1222220222221
1222220222221
1222220222221
1222220222221
1222220222221
1222220222221
1222220222221
1222220222221
1222220222221
1222220222221
1222220222221
1222220222221
1222220222221
1222220222221
1222220222221
1222220222221
1222220222221
1222220222221
1222220222221
1222220222221
1222220222221
1222220222221
1222220222221
1111111111111
